Player1,W,L,Player2,Win+/-,%
Martina Navratilova,40,3,Pam Shriver,37,93%
Chris Evert,40,6,Virginia Wade,34,85%
Steffi Graf,29,4,Jana Novotna,25,86%
Martina Navratilova,29,5,Wendy Turnbull,24,83%
Chris Evert,23,0,Virginia Ruzici,23,100%
Martina Navratilova,29,7,Hana Mandlikova,22,76%
Chris Evert,22,1,Sue Barker,21,95%
Martina Navratilova,21,0,Anne Smith,21,100%
Steffi Graf,21,0,Nathalie Tauziat,21,100%
Evonne Goolagong Cawley,30,10,Virginia Wade,20,67%
Steffi Graf,28,8,Arantxa Sanchez-Vicario,20,71%
Martina Navratilova,26,6,Helena Sukova,20,77%
Martina Navratilova,22,2,Claudia Kohde-Kilsch,20,91%
Chris Evert,21,1,Wendy Turnbull,20,95%
Steffi Graf,21,1,Helena Sukova,20,95%
Martina Navratilova,21,1,Mima Jausovec,20,95%
Steffi Graf,20,1,Natasha Zvereva,19,95%
Monica Seles,20,1,Conchita Mart\xc3\xadnez,19,95%
Steffi Graf,29,11,Gabriela Sabatini,18,62%
Martina Navratilova,18,0,Barbara Potter,18,100%
Monica Seles,20,3,Arantxa Sanchez-Vicario,17,85%
Steffi Graf,17,0,Manuela Maleeva-Fragniere,17,100%
Steffi Graf,17,0,Mary Joe Fernandez,17,100%
Martina Navratilova,17,0,Bettina Bunge,17,100%
Martina Hingis,18,2,Arantxa Sanchez-Vicario,16,89%
Serena Williams,18,2,Maria Sharapova,16,89%
Martina Hingis,16,0,Sandrine Testud,16,100%
Martina Navratilova,19,4,Dianne Fromholtz (balestrat),15,79%
Chris Evert,18,3,Pam Shriver,15,83%
Chris Evert,17,2,Manuela Maleeva-Fragniere,15,88%
Chris Evert,17,2,Helena Sukova,15,88%
Chris Evert,17,2,Dianne Fromholtz (balestrat),15,88%
Martina Navratilova,17,2,Sue Barker,15,88%
Hana Mandlikova,16,1,Bettina Bunge,15,94%
Chris Evert,15,0,Betty Stove,15,100%
Chris Evert,26,12,Evonne Goolagong Cawley,14,54%
Arantxa Sanchez-Vicario,18,4,Amanda Coetzer,14,78%
Chris Evert,17,3,Andrea Jaeger,14,82%
Serena Williams,17,3,Victoria Azarenka,14,82%
Chris Evert,15,1,Sylvia Hanika,14,93%
Chris Evert,15,1,Kerry Ann Melville (reid),14,93%
Monica Seles,15,1,Mary Joe Fernandez,14,93%
Chris Evert,14,0,Mima Jausovec,14,100%
Martina Navratilova,14,0,Yvonne Vermaak,14,100%
Martina Navratilova,14,0,Catarina Lindqvist,14,100%
Arantxa Sanchez-Vicario,14,0,Barbara Rittner,14,100%
Chris Evert,14,0,Bettina Bunge,14,100%
Billie Jean King,22,9,Virginia Wade,13,59%
Justine Henin,16,3,Svetlana Kuznetsova,13,81%
Martina Navratilova,16,3,Betty Stove,13,81%
Maria Sharapova,15,2,Samantha Stosur,13,87%
Chris Evert,13,0,Claudia Kohde-Kilsch,13,100%
Chris Evert,13,0,Olga Morozova,13,100%
Chris Evert,13,0,Regina Marsikova,13,100%
Martina Navratilova,13,0,Greer Stevens,13,100%
Martina Navratilova,13,0,Virginia Ruzici,13,100%
Tracy Austin,13,0,Virginia Ruzici,13,100%
Chris Evert,19,7,Hana Mandlikova,12,63%
Chris Evert,19,7,Billie Jean King,12,63%
Martina Navratilova,18,6,Virginia Wade,12,67%
Conchita Mart\xc3\xadnez,15,3,Amanda Coetzer,12,80%
Justine Henin,14,2,Nadia Petrova,12,86%
Martina Navratilova,14,2,Sylvia Hanika,12,86%
Virginia Wade,14,2,Mima Jausovec,12,86%
Steffi Graf,13,1,Conchita Mart\xc3\xadnez,12,92%
Jelena Jankovic,13,1,Alona Bondarenko,12,92%
Martina Navratilova,13,1,Kathy Jordan,12,92%
Chris Evert,12,0,Bonnie Gadusek,12,100%
Kim Clijsters,12,0,Francesca Schiavone,12,100%
Martina Navratilova,12,0,Ann Kiyomura,12,100%
Virginia Wade,12,0,Pam Teeguarden,12,100%
Martina Navratilova,12,0,Lori McNeil,12,100%
Maria Sharapova,13,2,Agnieszka Radwanska,11,85%
Rosie Casals,13,2,Pam Teeguarden,11,85%
Arantxa Sanchez-Vicario,12,1,Nathalie Tauziat,11,92%
Manuela Maleeva-Fragniere,12,1,Raffaella Reggi,11,92%
Martina Hingis,12,1,Anke Huber,11,92%
Am\xc3\xa9lie Mauresmo,11,0,Ai Sugiyama,11,100%
Chris Evert,11,0,Joanne Russell-Longdon,11,100%
Martina Hingis,11,0,Barbara Schett,11,100%
Steffi Graf,11,0,Katerina Maleeva,11,100%
Steffi Graf,11,0,Judith Wiesner,11,100%
Martina Navratilova,11,0,Rosalyn Nideffer,11,100%
Vera Zvonareva,11,0,Francesca Schiavone,11,100%
Venus Williams,11,0,Patty Schnyder,11,100%
Martina Hingis,15,5,Monica Seles,10,67%
Arantxa Sanchez-Vicario,14,4,Conchita Mart\xc3\xadnez,10,71%
Lindsay Davenport,13,3,Nathalie Tauziat,10,77%
Lindsay Davenport,13,3,Amanda Coetzer,10,77%
Lindsay Davenport,12,2,Sandrine Testud,10,83%
Steffi Graf,12,2,Claudia Kohde-Kilsch,10,83%
Hana Mandlikova,12,2,Helena Sukova,10,83%
Arantxa Sanchez-Vicario,12,2,Anke Huber,10,83%
Steffi Graf,12,2,Zina Garrison,10,83%
Martina Hingis,11,1,Anna Kournikova,10,91%
Pam Shriver,11,1,Alycia Moulton,10,91%
Conchita Mart\xc3\xadnez,11,1,Magdalena Maleeva,10,91%
Serena Williams,11,1,Na Li,10,91%
Evonne Goolagong Cawley,11,1,Dianne Fromholtz (balestrat),10,91%
Billie Jean King,11,1,Wendy Turnbull,10,91%
Justine Henin,10,0,Jelena Jankovic,10,100%
Lindsay Davenport,10,0,Elena Likhovtseva,10,100%
Lindsay Davenport,10,0,Amy Frazier,10,100%
Monica Seles,10,0,Nathalie Tauziat,10,100%
Monica Seles,10,0,Naoko Sawamatsu,10,100%
Steffi Graf,10,0,Anke Huber,10,100%
Martina Navratilova,10,0,Kate Latham,10,100%
Monica Seles,10,0,Ai Sugiyama,10,100%
Martina Navratilova,15,6,Gabriela Sabatini,9,60%
Pam Shriver,13,4,Bettina Bunge,9,69%
Chris Evert,12,3,Kathy Jordan,9,75%
Martina Navratilova,12,3,Arantxa Sanchez-Vicario,9,75%
Justine Henin,11,2,Elena Dementieva,9,82%
Arantxa Sanchez-Vicario,11,2,Zina Garrison,9,82%
Helena Sukova,11,2,Lori McNeil,9,82%
Steffi Graf,10,1,Jennifer Capriati,9,90%
Kim Clijsters,10,1,Daniela Hantuchova,9,90%
Lindsay Davenport,10,1,Ai Sugiyama,9,90%
Martina Navratilova,10,1,Joanne Russell-Longdon,9,90%
Serena Williams,10,1,Caroline Wozniacki,9,90%
Tracy Austin,10,1,Anne Smith,9,90%
Martina Navratilova,10,1,Kathleen Horvath,9,90%
Jana Novotna,10,1,Patricia Hy-Boulais,9,90%
Gabriela Sabatini,10,1,Nathalie Tauziat,9,90%
Nadia Petrova,10,1,Jie Zheng,9,90%
Francesca Schiavone,10,1,Aliz\xc3\xa9 Cornet,9,90%
Chris Evert,9,0,Kathy Rinaldi Stunkel,9,100%
Chris Evert,9,0,Sharon Walsh,9,100%
Chris Evert,9,0,Kate Latham,9,100%
Lindsay Davenport,9,0,Jelena Dokic,9,100%
Martina Navratilova,9,0,Sharon Walsh,9,100%
Serena Williams,9,0,Sara Errani,9,100%
Serena Williams,9,0,Lucie Safarova,9,100%
Steffi Graf,9,0,Andrea Temesvari,9,100%
Arantxa Sanchez-Vicario,9,0,Leila Meskhi,9,100%
Venus Williams,9,0,Elena Likhovtseva,9,100%
Caroline Wozniacki,9,0,Jarmila Wolfe,9,100%
Monica Seles,9,0,Manuela Maleeva-Fragniere,9,100%
Pam Shriver,9,0,Wendy Prausa,9,100%
Monica Seles,9,0,Anke Huber,9,100%
Chris Evert,9,0,Carling Bassett-Seguso,9,100%
Natasha Zvereva,9,0,Brenda Schultz-McCarthy,9,100%
Lindsay Davenport,12,4,Am\xc3\xa9lie Mauresmo,8,67%
Elena Dementieva,12,4,Daniela Hantuchova,8,67%
Arantxa Sanchez-Vicario,11,3,Natasha Zvereva,8,73%
Kim Clijsters,11,3,Elena Dementieva,8,73%
Martina Hingis,11,3,Conchita Mart\xc3\xadnez,8,73%
Ana Ivanovic,11,3,Svetlana Kuznetsova,8,73%
Monica Seles,11,3,Gabriela Sabatini,8,73%
Martina Navratilova,11,3,Manuela Maleeva-Fragniere,8,73%
Serena Williams,10,2,Am\xc3\xa9lie Mauresmo,8,80%
Lindsay Davenport,10,2,Anke Huber,8,80%
Lindsay Davenport,10,2,Patty Schnyder,8,80%
Elena Dementieva,10,2,Nathalie Dechy,8,80%
Pam Shriver,10,2,Rosalyn Nideffer,8,80%
Martina Hingis,10,2,Amanda Coetzer,8,80%
Virginia Wade,10,2,Dianne Fromholtz (balestrat),8,80%
Andrea Jaeger,10,2,Sylvia Hanika,8,80%
Arantxa Sanchez-Vicario,9,1,Brenda Schultz-McCarthy,8,89%
Martina Navratilova,9,1,Nathalie Tauziat,8,89%
Martina Navratilova,9,1,Kerry Ann Melville (reid),8,89%
Martina Navratilova,9,1,Larisa Neiland,8,89%
Venus Williams,9,1,Monica Seles,8,89%
Serena Williams,9,1,Ana Ivanovic,8,89%
Steffi Graf,9,1,Julie Halard-Decugis,8,89%
Vera Zvonareva,9,1,Nathalie Dechy,8,89%
Venus Williams,9,1,Silvia Farina Elia,8,89%
Monica Seles,9,1,Amy Frazier,8,89%
Jelena Jankovic,9,1,Sybille Bammer,8,89%
Pam Shriver,9,1,Betsy Nagelsen,8,89%
Monica Seles,9,1,Amanda Coetzer,8,89%
Maria Sharapova,9,1,Nadia Petrova,8,89%
Maria Sharapova,9,1,Daniela Hantuchova,8,89%
Serena Williams,9,1,Daniela Hantuchova,8,89%
Venus Williams,9,1,Chanda Rubin,8,89%
Chris Evert,8,0,Barbara Potter,8,100%
Chris Evert,8,0,Anne Smith,8,100%
Chris Evert,8,0,Alycia Moulton,8,100%
Jelena Jankovic,8,0,Anabel Medina Garrigues,8,100%
Jennifer Capriati,8,0,Meghann Shaughnessy,8,100%
Lindsay Davenport,8,0,Nathalie Dechy,8,100%
Martina Hingis,8,0,Elena Likhovtseva,8,100%
Martina Navratilova,8,0,Raffaella Reggi,8,100%
Martina Navratilova,8,0,Mary Lou Daniels,8,100%
Serena Williams,8,0,Agnieszka Radwanska,8,100%
Serena Williams,8,0,Maria Kirilenko,8,100%
Steffi Graf,8,0,Magdalena Maleeva,8,100%
Tracy Austin,8,0,Mima Jausovec,8,100%
Tracy Austin,8,0,Betsy Nagelsen,8,100%
Gabriela Sabatini,8,0,Helen Kelesi,8,100%
Pam Shriver,8,0,Eva Pfaff,8,100%
Martina Navratilova,8,0,Gigi Fernandez,8,100%
Steffi Graf,8,0,Bettina Fulco-Vilella,8,100%
Arantxa Sanchez-Vicario,8,0,Florencia Labat,8,100%
Patty Schnyder,8,0,Virginia Ruano Pascual,8,100%
Elena Likhovtseva,8,0,Janette Husarova,8,100%
Venus Williams,8,0,Francesca Schiavone,8,100%
Helena Sukova,8,0,Robin White,8,100%
Martina Navratilova,8,0,Mary Joe Fernandez,8,100%
Hana Mandlikova,8,0,Sue Barker,8,100%
Petra Kvitova,8,0,Lucie Safarova,8,100%
Marion Bartoli,8,0,Ayumi Morita,8,100%
Venus Williams,8,0,Anna Kournikova,8,100%
Virginia Ruzici,8,0,Sharon Walsh,8,100%
Martina Navratilova,20,13,Tracy Austin,7,35%
Am\xc3\xa9lie Mauresmo,13,6,Patty Schnyder,7,54%
Victoria Azarenka,12,5,Agnieszka Radwanska,7,58%
Billie Jean King,11,4,Evonne Goolagong Cawley,7,64%
Martina Navratilova,11,4,Andrea Jaeger,7,64%
Svetlana Kuznetsova,11,4,Agnieszka Radwanska,7,64%
Steffi Graf,11,4,Amanda Coetzer,7,64%
Lindsay Davenport,10,3,Monica Seles,7,70%
Gabriela Sabatini,10,3,Jana Novotna,7,70%
Lucie Safarova,10,3,Samantha Stosur,7,70%
Gabriela Sabatini,10,3,Zina Garrison,7,70%
Chris Evert,9,2,Zina Garrison,7,78%
Lindsay Davenport,9,2,Julie Halard-Decugis,7,78%
Monica Seles,9,2,Sandrine Testud,7,78%
Steffi Graf,9,2,Lori McNeil,7,78%
Nathalie Dechy,9,2,Meghann Shaughnessy,7,78%
Helena Sukova,9,2,Rosalyn Nideffer,7,78%
Nadia Petrova,9,2,Katarina Srebotnik,7,78%
Agnieszka Radwanska,9,2,Tsvetana Pironkova,7,78%
Dominika Cibulkova,9,2,Tsvetana Pironkova,7,78%
Mona Barthel,9,2,Kiki Bertens,7,78%
Sue Barker,9,2,Betsy Nagelsen,7,78%
Vera Zvonareva,9,2,Marion Bartoli,7,78%
Am\xc3\xa9lie Mauresmo,8,1,Anastasia Myskina,7,88%
Am\xc3\xa9lie Mauresmo,8,1,Vera Zvonareva,7,88%
Maria Sharapova,8,1,Jelena Jankovic,7,88%
Justine Henin,8,1,Patty Schnyder,7,88%
Kim Clijsters,8,1,Jelena Jankovic,7,88%
Steffi Graf,8,1,Hana Mandlikova,7,88%
Tracy Austin,8,1,Kathy Jordan,7,88%
Arantxa Sanchez-Vicario,8,1,Sabine Hack,7,88%
Shuai Peng,8,1,Ayumi Morita,7,88%
Andrea Jaeger,8,1,Mima Jausovec,7,88%
Andrea Jaeger,8,1,Virginia Ruzici,7,88%
Caroline Wozniacki,8,1,Aleksandra Wozniak,7,88%
Arantxa Sanchez-Vicario,8,1,Bettina Fulco-Vilella,7,88%
Venus Williams,8,1,Amanda Coetzer,7,88%
Gabriela Sabatini,8,1,Natasha Zvereva,7,88%
Patty Schnyder,8,1,Denisa Chladkova,7,88%
Anke Huber,8,1,Barbara Rittner,7,88%
Mary Joe Fernandez,8,1,Judith Wiesner,7,88%
Andrea Jaeger,8,1,Sue Barker,7,88%
Zina Garrison,8,1,Raffaella Reggi,7,88%
Gabriela Sabatini,8,1,Katerina Maleeva,7,88%
Manuela Maleeva-Fragniere,8,1,Katerina Maleeva,7,88%
Anna Lapushchenkova,8,1,Vitalia Diatchenko,7,88%
Am\xc3\xa9lie Mauresmo,7,0,Tatiana Panova,7,100%
Ana Ivanovic,7,0,Elina Svitolina,7,100%
Chris Evert,7,0,Mary Joe Fernandez,7,100%
Chris Evert,7,0,Kathleen Horvath,7,100%
Chris Evert,7,0,Peanut Harper,7,100%
Chris Evert,7,0,Yvonne Vermaak,7,100%
Justine Henin,7,0,Conchita Mart\xc3\xadnez,7,100%
Kim Clijsters,7,0,Chanda Rubin,7,100%
Lindsay Davenport,7,0,Nadia Petrova,7,100%
Lindsay Davenport,7,0,Daniela Hantuchova,7,100%
Lindsay Davenport,7,0,Barbara Schett,7,100%
Lindsay Davenport,7,0,Paola Su\xc3\xa1rez,7,100%
Lindsay Davenport,7,0,Ruxandra Dragomir Ilie,7,100%
Maria Sharapova,7,0,Anna Chakvetadze,7,100%
Maria Sharapova,7,0,Shahar Peer,7,100%
Martina Navratilova,7,0,Kathy Rinaldi Stunkel,7,100%
Martina Navratilova,7,0,Catherine Tanvier,7,100%
Martina Navratilova,7,0,Wendy Prausa,7,100%
Steffi Graf,7,0,Iva Majoli,7,100%
Steffi Graf,7,0,Chanda Rubin,7,100%
Tracy Austin,7,0,Kate Latham,7,100%
Venus Williams,7,0,Caroline Wozniacki,7,100%
Wendy Turnbull,7,0,Anne Smith,7,100%
Martina Hingis,7,0,Nathalie Dechy,7,100%
Am\xc3\xa9lie Mauresmo,7,0,Silvia Farina Elia,7,100%
Conchita Mart\xc3\xadnez,7,0,Leila Meskhi,7,100%
Amy Frazier,7,0,Debbie Graham,7,100%
Hana Mandlikova,7,0,Rosalyn Nideffer,7,100%
Kathy Rinaldi Stunkel,7,0,Rosalyn Nideffer,7,100%
Mary Pierce,7,0,Sabine Appelmans,7,100%
Dominique Monami,7,0,Sabine Appelmans,7,100%
Steffi Graf,7,0,Patty Fendick,7,100%
Venus Williams,7,0,Tamarine Tanasugarn,7,100%
Jana Novotna,7,0,Yayuk Basuki,7,100%
Conchita Mart\xc3\xadnez,7,0,Barbara Rittner,7,100%
Jana Novotna,7,0,Sandrine Testud,7,100%
Na Li,7,0,Dominika Cibulkova,7,100%
Svetlana Kuznetsova,7,0,Anabel Medina Garrigues,7,100%
Martina Navratilova,7,0,Anne Harris,7,100%
Sandrine Testud,7,0,Miriam Oremans,7,100%
Helena Sukova,7,0,Elise Burgin,7,100%
Emmanuelle Gagliardi,7,0,Kristina Brandi,7,100%
Gabriela Sabatini,7,0,Patricia Hy-Boulais,7,100%
Kim Clijsters,7,0,Cara Black,7,100%
Gabriela Sabatini,7,0,Isabelle Demongeot,7,100%
Pam Shriver,7,0,Anne White,7,100%
Anke Huber,7,0,Elena Likhovtseva,7,100%
Claudia Kohde-Kilsch,7,0,Katerina Maleeva,7,100%
Samantha Stosur,7,0,Monica Niculescu,7,100%
Daniela Hantuchova,7,0,Barbara Schett,7,100%
Daniela Hantuchova,7,0,Katarina Srebotnik,7,100%
Daniela Hantuchova,7,0,Vania King,7,100%
Yuka Yoshida,7,0,Jane Chi,7,100%
Dinara Safina,7,0,Flavia Pennetta,7,100%
Serena Williams,7,0,Flavia Pennetta,7,100%
Flavia Pennetta,7,0,Samantha Stosur,7,100%
Evgeniya Rodina,7,0,Anna Lapushchenkova,7,100%
Agnieszka Radwanska,7,0,Marion Bartoli,7,100%
Venus Williams,7,0,Ai Sugiyama,7,100%
Caroline Wozniacki,7,0,Ekaterina Makarova,7,100%
Jana Novotna,7,0,Dominique Monami,7,100%
Pam Shriver,7,0,Lori McNeil,7,100%
Martina Navratilova,43,37,Chris Evert,6,14%
Mary Pierce,12,6,Conchita Mart\xc3\xadnez,6,50%
Gabriela Sabatini,12,6,Helena Sukova,6,50%
Gabriela Sabatini,11,5,Jennifer Capriati,6,55%
Lindsay Davenport,11,5,Elena Dementieva,6,55%
Serena Williams,10,4,Jelena Jankovic,6,60%
Serena Williams,10,4,Lindsay Davenport,6,60%
Maria Sharapova,10,4,Ana Ivanovic,6,60%
Ana Ivanovic,9,3,Jelena Jankovic,6,67%
Lindsay Davenport,9,3,Jennifer Capriati,6,67%
Lindsay Davenport,9,3,Chanda Rubin,6,67%
Martina Hingis,9,3,Jana Novotna,6,67%
Steffi Graf,9,3,Pam Shriver,6,67%
Venus Williams,9,3,Ana Ivanovic,6,67%
Caroline Wozniacki,9,3,Dominika Cibulkova,6,67%
Zina Garrison,9,3,Gigi Fernandez,6,67%
Conchita Mart\xc3\xadnez,9,3,Chanda Rubin,6,67%
Virginia Wade,9,3,Sharon Walsh,6,67%
Maria Sharapova,9,3,Elena Dementieva,6,67%
Venus Williams,9,3,Elena Dementieva,6,67%
Pam Shriver,9,3,Helena Sukova,6,67%
Victoria Azarenka,9,3,Marion Bartoli,6,67%
Jelena Jankovic,8,2,Flavia Pennetta,6,75%
Jennifer Capriati,8,2,Magdalena Maleeva,6,75%
Justine Henin,8,2,Anastasia Myskina,6,75%
Kim Clijsters,8,2,Dinara Safina,6,75%
Martina Hingis,8,2,Iva Majoli,6,75%
Martina Hingis,8,2,Chanda Rubin,6,75%
Serena Williams,8,2,Vera Zvonareva,6,75%
Tracy Austin,8,2,Andrea Jaeger,6,75%
Tracy Austin,8,2,Barbara Potter,6,75%
Conchita Mart\xc3\xadnez,8,2,Sabine Hack,6,75%
Elena Bovina,8,2,Francesca Schiavone,6,75%
Vera Zvonareva,8,2,Shuai Peng,6,75%
Conchita Mart\xc3\xadnez,8,2,Nathalie Tauziat,6,75%
Serena Williams,8,2,Svetlana Kuznetsova,6,75%
Mary Pierce,8,2,Amanda Coetzer,6,75%
Hana Mandlikova,8,2,Pam Shriver,6,75%
Arantxa Sanchez-Vicario,8,2,Kimiko Date-Krumm,6,75%
Samantha Stosur,8,2,Vera Zvonareva,6,75%
Ana Ivanovic,7,1,Anastasia Pavlyuchenkova,6,86%
Arantxa Sanchez-Vicario,7,1,Ai Sugiyama,6,86%
Arantxa Sanchez-Vicario,7,1,Judith Wiesner,6,86%
Jelena Jankovic,7,1,Elena Vesnina,6,86%
Jennifer Capriati,7,1,Anke Huber,6,86%
Justine Henin,7,1,Francesca Schiavone,6,86%
Kim Clijsters,7,1,Svetlana Kuznetsova,6,86%
Lindsay Davenport,7,1,Silvia Farina Elia,6,86%
Steffi Graf,7,1,Nicole Bradtke,6,86%
Venus Williams,7,1,Vera Zvonareva,6,86%
Silvia Farina Elia,7,1,Mar\xc3\xada S\xc3\xa1nchez Lorenzo,6,86%
Am\xc3\xa9lie Mauresmo,7,1,Elena Likhovtseva,6,86%
Irina Spirlea,7,1,Elena Likhovtseva,6,86%
Barbara Schett,7,1,Elena Likhovtseva,6,86%
Zina Garrison,7,1,Rosalyn Nideffer,6,86%
Katerina Maleeva,7,1,Gigi Fernandez,6,86%
Andrea Jaeger,7,1,Joanne Russell-Longdon,6,86%
Conchita Mart\xc3\xadnez,7,1,Judith Wiesner,6,86%
Jana Novotna,7,1,Radka Zrubakova,6,86%
Na Li,7,1,Angelique Kerber,6,86%
Na Li,7,1,Lucie Safarova,6,86%
Svetlana Kuznetsova,7,1,Jie Zheng,6,86%
Henrieta Nagyova,7,1,Cristina Torrens Valero,6,86%
Anabel Medina Garrigues,7,1,Tathiana Garbin,6,86%
Martina Navratilova,7,1,Betsy Nagelsen,6,86%
Virginia Wade,7,1,Betsy Nagelsen,6,86%
Mary Lou Daniels,7,1,Betsy Nagelsen,6,86%
Gabriela Sabatini,7,1,Amanda Coetzer,6,86%
Hana Mandlikova,7,1,Barbara Potter,6,86%
Manuela Maleeva-Fragniere,7,1,Mercedes Paz,6,86%
Nadia Petrova,7,1,Anna-Lena Groenefeld,6,86%
Barbara Potter,7,1,Sandy Collins,6,86%
Anke Huber,7,1,Irina Spirlea,6,86%
Claudia Kohde-Kilsch,7,1,Marcella Mesker,6,86%
Nadia Petrova,7,1,Lilia Osterloh,6,86%
Jill Craybas,7,1,Akgul Amanmuradova,6,86%
Steffi Graf,7,1,Kimiko Date-Krumm,6,86%
Magdalena Maleeva,7,1,Chanda Rubin,6,86%
Venus Williams,7,1,Samantha Stosur,6,86%
Petra Kvitova,7,1,Samantha Stosur,6,86%
Caroline Wozniacki,7,1,Daniela Hantuchova,6,86%
Bettina Bunge,7,1,Rosalyn Nideffer,6,86%
Caroline Wozniacki,7,1,Flavia Pennetta,6,86%
Martina Navratilova,7,1,Katerina Maleeva,6,86%
Conchita Mart\xc3\xadnez,7,1,Katerina Maleeva,6,86%
Anne Smith,7,1,Barbara Potter,6,86%
Marion Bartoli,7,1,Lucie Safarova,6,86%
Marion Bartoli,7,1,Jill Craybas,6,86%
Maria Sharapova,7,1,Patty Schnyder,6,86%
Chris Evert,7,1,Lisa Bonder-Kreiss,6,86%
Arantxa Sanchez-Vicario,6,0,Naoko Sawamatsu,6,100%
Arantxa Sanchez-Vicario,6,0,Magui Serna,6,100%
Arantxa Sanchez-Vicario,6,0,Tami Jones,6,100%
Chris Evert,6,0,Greer Stevens,6,100%
Chris Evert,6,0,Stephanie Rehe,6,100%
Chris Evert,6,0,Rosalyn Nideffer,6,100%
Chris Evert,6,0,Betsy Nagelsen,6,100%
Chris Evert,6,0,Ann Kiyomura,6,100%
Jelena Jankovic,6,0,Tsvetana Pironkova,6,100%
Jennifer Capriati,6,0,Amy Frazier,6,100%
Justine Henin,6,0,Vera Zvonareva,6,100%
Kim Clijsters,6,0,Ana Ivanovic,6,100%
Kim Clijsters,6,0,Magdalena Maleeva,6,100%
Kim Clijsters,6,0,Silvia Farina Elia,6,100%
Lindsay Davenport,6,0,Jana Novotna,6,100%
Lindsay Davenport,6,0,Vera Zvonareva,6,100%
Lindsay Davenport,6,0,Magui Serna,6,100%
Maria Sharapova,6,0,Simona Halep,6,100%
Maria Sharapova,6,0,Ekaterina Makarova,6,100%
Martina Hingis,6,0,Nathalie Tauziat,6,100%
Martina Hingis,6,0,Irina Spirlea,6,100%
Martina Navratilova,6,0,Robin White,6,100%
Martina Navratilova,6,0,Terry Phelps,6,100%
Martina Navratilova,6,0,Elna Reinach,6,100%
Monica Seles,6,0,Tamarine Tanasugarn,6,100%
Serena Williams,6,0,Carla Su\xc3\xa1rez Navarro,6,100%
Serena Williams,6,0,Jie Zheng,6,100%
Steffi Graf,6,0,Brenda Schultz-McCarthy,6,100%
Steffi Graf,6,0,Leila Meskhi,6,100%
Steffi Graf,6,0,Helen Kelesi,6,100%
Steffi Graf,6,0,Larisa Neiland,6,100%
Venus Williams,6,0,Shahar Peer,6,100%
Venus Williams,6,0,Fabiola Zuluaga,6,100%
Arantxa Sanchez-Vicario,6,0,Barbara Paulus,6,100%
Hana Mandlikova,6,0,Kathleen Horvath,6,100%
Justine Henin,6,0,Nathalie Dechy,6,100%
Nathalie Dechy,6,0,Janette Husarova,6,100%
Roberta Vinci,6,0,S\xc3\xadlvia Soler-Espinosa,6,100%
Simona Halep,6,0,Anastasia Pavlyuchenkova,6,100%
Gabriela Sabatini,6,0,Raffaella Reggi,6,100%
Pam Shriver,6,0,Raffaella Reggi,6,100%
Justine Henin,6,0,Elena Bovina,6,100%
Maria Sharapova,6,0,Eleni Daniilidou,6,100%
Samantha Stosur,6,0,Shuai Peng,6,100%
Flavia Pennetta,6,0,Shuai Peng,6,100%
Anna Smashnova,6,0,Meilen Tu,6,100%
Elena Likhovtseva,6,0,Nicole Pratt,6,100%
Steffi Graf,6,0,Rosalyn Nideffer,6,100%
Rosalyn Nideffer,6,0,Marianne Werdel-Witmeyer,6,100%
Rosalyn Nideffer,6,0,Kim Sands,6,100%
Martina Navratilova,6,0,Sandra Cecchini,6,100%
Sandra Cecchini,6,0,Petra Schwarz,6,100%
Anna Chakvetadze,6,0,Anabel Medina Garrigues,6,100%
Martina Hingis,6,0,Sabine Appelmans,6,100%
Monica Seles,6,0,Sabine Appelmans,6,100%
Samantha Stosur,6,0,Virginie Razzano,6,100%
Helena Sukova,6,0,Belinda Cordwell,6,100%
Martina Navratilova,6,0,Peanut Harper,6,100%
Serena Williams,6,0,Tamarine Tanasugarn,6,100%
Petra Kvitova,6,0,Varvara Lepchenko,6,100%
Conchita Mart\xc3\xadnez,6,0,Miriam Oremans,6,100%
Conchita Mart\xc3\xadnez,6,0,Patricia Tarabini,6,100%
Jana Novotna,6,0,Irina Spirlea,6,100%
Jana Novotna,6,0,Wiltrud Probst,6,100%
Victoria Azarenka,6,0,Elena Vesnina,6,100%
Wendy Turnbull,6,0,Leslie Allen,6,100%
Tathiana Garbin,6,0,Yvonne Meusburger,6,100%
Judith Wiesner,6,0,Bettina Fulco-Vilella,6,100%
Martina Navratilova,6,0,Iva Budarova,6,100%
Hana Mandlikova,6,0,Iva Budarova,6,100%
Ana Ivanovic,6,0,Iveta Melzer,6,100%
Na Li,6,0,Iveta Melzer,6,100%
Pam Shriver,6,0,Etsuko Kaneshiro,6,100%
Brenda Schultz-McCarthy,6,0,Florencia Labat,6,100%
Kristina Brandi,6,0,Angela Haynes,6,100%
Caroline Wozniacki,6,0,Monica Niculescu,6,100%
Kateryna Bondarenko,6,0,Yuliana Fedak,6,100%
Kaia Kanepi,6,0,Sofia Arvidsson,6,100%
Maria Sharapova,6,0,Bethanie Mattek-Sands,6,100%
Bethanie Mattek-Sands,6,0,Melanie Oudin,6,100%
Vera Zvonareva,6,0,Maria Kirilenko,6,100%
Amanda Coetzer,6,0,Virginia Ruano Pascual,6,100%
Elena Dementieva,6,0,Iva Majoli,6,100%
Elena Dementieva,6,0,Aravane Rezai,6,100%
Hana Mandlikova,6,0,Lori McNeil,6,100%
Hana Mandlikova,6,0,Susan Mascarin,6,100%
Nadia Petrova,6,0,Shahar Peer,6,100%
Cara Black,6,0,Rita Grande,6,100%
Pam Shriver,6,0,Anne Hobbs,6,100%
Mary Joe Fernandez,6,0,Isabelle Demongeot,6,100%
Catarina Lindqvist,6,0,Ann Henricksson,6,100%
Camille Pin,6,0,Yvonne Meusburger,6,100%
Daniela Hantuchova,6,0,Jill Craybas,6,100%
Vera Dushevina,6,0,Jill Craybas,6,100%
Nathalie Tauziat,6,0,Shi-Ting Wang,6,100%
Claudia Kohde-Kilsch,6,0,Alycia Moulton,6,100%
Helena Sukova,6,0,Dianne Fromholtz (balestrat),6,100%
Dianne Fromholtz (balestrat),6,0,Joanne Russell-Longdon,6,100%
Ana Ivanovic,6,0,Francesca Schiavone,6,100%
Francesca Schiavone,6,0,Tsvetana Pironkova,6,100%
Jelena Dokic,6,0,Emmanuelle Gagliardi,6,100%
Angelique Kerber,6,0,Lucie Hradecka,6,100%
Renata Voracova,6,0,Maria Elena Camerin,6,100%
Silvia Farina Elia,6,0,Els Callens,6,100%
Petra Mandula,6,0,Anca Barna,6,100%
Shahar Peer,6,0,Akgul Amanmuradova,6,100%
Martina Navratilova,6,0,Pat Medrado,6,100%
Mary Joe Fernandez,6,0,Barbara Rittner,6,100%
Nicole Vaidisova,6,0,Samantha Stosur,6,100%
Zina Garrison,6,0,Terry Phelps,6,100%
Angelique Kerber,6,0,Sabine Lisicki,6,100%
Daniela Hantuchova,6,0,Jie Zheng,6,100%
Sara Errani,6,0,Johanna Larsson,6,100%
Bettina Bunge,6,0,Mary Lou Daniels,6,100%
Ksenia Pervak,6,0,Alexandra Panova,6,100%
Valeria Savinykh,6,0,Renata Voracova,6,100%
Flavia Pennetta,6,0,Martina Sucha,6,100%
Claudia Kohde-Kilsch,6,0,Mima Jausovec,6,100%
Barbara Potter,6,0,Joanne Russell-Longdon,6,100%
Monica Seles,6,0,Barbara Schett,6,100%
Jana Novotna,6,0,Julie Halard-Decugis,6,100%
Casey Dellacqua,6,0,Melanie South,6,100%
Gabriela Sabatini,6,0,Kathy Rinaldi Stunkel,6,100%
Francesca Schiavone,6,0,Ai Sugiyama,6,100%
Carla Su\xc3\xa1rez Navarro,6,0,S\xc3\xadlvia Soler-Espinosa,6,100%
Martina Navratilova,6,0,Carling Bassett-Seguso,6,100%
Virginia Ruzici,6,0,Pam Teeguarden,6,100%
Agnieszka Radwanska,6,0,Andrea Petkovic,6,100%
Martina Navratilova,6,0,Lisa Bonder-Kreiss,6,100%
Arantxa Sanchez-Vicario,6,0,Lori McNeil,6,100%
Lori McNeil,6,0,Elna Reinach,6,100%
Serena Williams,16,11,Venus Williams,5,31%
Steffi Graf,10,5,Monica Seles,5,50%
Maria Sharapova,10,5,Na Li,5,50%
Helena Sukova,10,5,Claudia Kohde-Kilsch,5,50%
Hana Mandlikova,10,5,Sylvia Hanika,5,50%
Samantha Stosur,9,4,Francesca Schiavone,5,56%
Hana Mandlikova,9,4,Zina Garrison,5,56%
Virginia Ruzici,9,4,Mima Jausovec,5,56%
Kim Clijsters,8,3,Vera Zvonareva,5,63%
Wendy Turnbull,8,3,Rosalyn Nideffer,5,63%
Conchita Mart\xc3\xadnez,8,3,Patty Schnyder,5,63%
Wendy Turnbull,8,3,Sharon Walsh,5,63%
Dianne Fromholtz (balestrat),8,3,Sue Barker,5,63%
Jana Novotna,8,3,Iva Majoli,5,63%
Serena Williams,8,3,Samantha Stosur,5,63%
Pam Shriver,8,3,Sylvia Hanika,5,63%
Marion Bartoli,8,3,Anabel Medina Garrigues,5,63%
Virginia Wade,8,3,Virginia Ruzici,5,63%
Jelena Jankovic,7,2,Nadia Petrova,5,71%
Jelena Jankovic,7,2,Samantha Stosur,5,71%
Jelena Jankovic,7,2,Lucie Safarova,5,71%
Venus Williams,7,2,Justine Henin,5,71%
Serena Williams,7,2,Kim Clijsters,5,71%
Martina Navratilova,7,2,Pam Teeguarden,5,71%
Steffi Graf,7,2,Martina Hingis,5,71%
Tracy Austin,7,2,Hana Mandlikova,5,71%
Manuela Maleeva-Fragniere,7,2,Catarina Lindqvist,5,71%
Agnieszka Radwanska,7,2,Roberta Vinci,5,71%
Conchita Mart\xc3\xadnez,7,2,Silvia Farina Elia,5,71%
Silvia Farina Elia,7,2,Silvija Talaja,5,71%
Arantxa Sanchez-Vicario,7,2,Sabine Appelmans,5,71%
Helena Sukova,7,2,Eva Pfaff,5,71%
Gigi Fernandez,7,2,Robin White,5,71%
Bettina Bunge,7,2,Leslie Allen,5,71%
Brenda Schultz-McCarthy,7,2,Rachel McQuillan,5,71%
Caroline Wozniacki,7,2,Sofia Arvidsson,5,71%
Amanda Coetzer,7,2,Anna Kournikova,5,71%
Elena Dementieva,7,2,Katarina Srebotnik,5,71%
Hana Mandlikova,7,2,Catherine Tanvier,5,71%
Hana Mandlikova,7,2,Elizabeth Smylie,5,71%
Gabriela Sabatini,7,2,Manuela Maleeva-Fragniere,5,71%
Pam Shriver,7,2,Manuela Maleeva-Fragniere,5,71%
Mary Pierce,7,2,Patty Schnyder,5,71%
Wendy Turnbull,7,2,Ann Kiyomura,5,71%
Arantxa  Parra Santonja,7,2,Severine Beltrame,5,71%
Wendy Turnbull,7,2,Wendy Prausa,5,71%
Anke Huber,7,2,Conchita Mart\xc3\xadnez,5,71%
Anke Huber,7,2,Judith Wiesner,5,71%
Pam Shriver,7,2,Claudia Kohde-Kilsch,5,71%
Serena Williams,7,2,Francesca Schiavone,5,71%
Nathalie Tauziat,7,2,Magdalena Maleeva,5,71%
Evonne Goolagong Cawley,7,2,Sue Barker,5,71%
Sue Barker,7,2,Ann Kiyomura,5,71%
Kathy Jordan,7,2,Virginia Wade,5,71%
Victoria Azarenka,7,2,Sara Errani,5,71%
Mima Jausovec,7,2,Joanne Russell-Longdon,5,71%
Conchita Mart\xc3\xadnez,7,2,Julie Halard-Decugis,5,71%
Lori McNeil,7,2,Larisa Neiland,5,71%
Am\xc3\xa9lie Mauresmo,6,1,Anna Smashnova,5,83%
Serena Williams,6,1,Dinara Safina,5,83%
Am\xc3\xa9lie Mauresmo,6,1,Jelena Jankovic,5,83%
Simona Halep,6,1,Jelena Jankovic,5,83%
Jelena Jankovic,6,1,Jie Zheng,5,83%
Jelena Jankovic,6,1,Vera Dushevina,5,83%
Lindsay Davenport,6,1,Irina Spirlea,5,83%
Maria Sharapova,6,1,Sabine Lisicki,5,83%
Martina Navratilova,6,1,Jana Novotna,5,83%
Serena Williams,6,1,Simona Halep,5,83%
Tracy Austin,6,1,Sylvia Hanika,5,83%
Tracy Austin,6,1,Peanut Harper,5,83%
Arantxa Sanchez-Vicario,6,1,Karina Habsudova,5,83%
Caroline Wozniacki,6,1,Aliz\xc3\xa9 Cornet,5,83%
Agnieszka Radwanska,6,1,Aliz\xc3\xa9 Cornet,5,83%
Nathalie Dechy,6,1,Nicole Pratt,5,83%
Caroline Wozniacki,6,1,Shahar Peer,5,83%
Julie Halard-Decugis,6,1,Silvia Farina Elia,5,83%
Yanina Wickmayer,6,1,Julia Goerges,5,83%
Martina Hingis,6,1,Amy Frazier,5,83%
Steffi Graf,6,1,Amy Frazier,5,83%
Helena Sukova,6,1,Larisa Neiland,5,83%
Pam Shriver,6,1,Larisa Neiland,5,83%
Judith Wiesner,6,1,Larisa Neiland,5,83%
Hana Mandlikova,6,1,Laura Arraya,5,83%
Conchita Mart\xc3\xadnez,6,1,Elena Likhovtseva,5,83%
Sandrine Testud,6,1,Elena Likhovtseva,5,83%
Gabriela Sabatini,6,1,Sandra Cecchini,5,83%
Ana Ivanovic,6,1,Virginie Razzano,5,83%
Virginia Ruzici,6,1,Ivanna Madruga-Osses,5,83%
Marion Bartoli,6,1,Alona Bondarenko,5,83%
Varvara Lepchenko,6,1,Olga Puchkova,5,83%
Maria Sharapova,6,1,Klara Koukalova,5,83%
Anastasia Myskina,6,1,Alexandra Stevenson,5,83%
Nadia Petrova,6,1,Na Li,5,83%
Samantha Stosur,6,1,Na Li,5,83%
Na Li,6,1,Sara Errani,5,83%
Na Li,6,1,Shuai Peng,5,83%
Svetlana Kuznetsova,6,1,Ai Sugiyama,5,83%
Svetlana Kuznetsova,6,1,Sara Errani,5,83%
Caroline Wozniacki,6,1,Elena Vesnina,5,83%
Ekaterina Makarova,6,1,Elena Vesnina,5,83%
Nadia Petrova,6,1,Tathiana Garbin,5,83%
Nathalie Tauziat,6,1,Elna Reinach,5,83%
Zina Garrison,6,1,Elise Burgin,5,83%
Terry Phelps,6,1,Elise Burgin,5,83%
Conchita Mart\xc3\xadnez,6,1,Asa Svensson,5,83%
Conchita Mart\xc3\xadnez,6,1,Ginger Nielsen,5,83%
Judith Wiesner,6,1,Kristie Boogert,5,83%
Vera Zvonareva,6,1,Elena Vesnina,5,83%
Amanda Coetzer,6,1,Magui Serna,5,83%
Elena Dementieva,6,1,Shahar Peer,5,83%
Manuela Maleeva-Fragniere,6,1,Kathy Rinaldi Stunkel,5,83%
Mary Pierce,6,1,Sandrine Testud,5,83%
Anabel Medina Garrigues,6,1,Nuria Llagostera Vives,5,83%
Angelique Kerber,6,1,Olga Govortsova,5,83%
Pam Shriver,6,1,Ann Henricksson,5,83%
Virginie Razzano,6,1,Jill Craybas,5,83%
Martina Navratilova,6,1,Terry Holladay,5,83%
Anke Huber,6,1,Natasha Zvereva,5,83%
Francesca Schiavone,6,1,Maria Kirilenko,5,83%
Maureen Drake,6,1,Anne Kremer,5,83%
Maureen Drake,6,1,Erika De Lone,5,83%
Angelique Kerber,6,1,Anne Keothavong,5,83%
Marissa Gould,6,1,Sarah Taylor,5,83%
Am\xc3\xa9lie Mauresmo,6,1,Magdalena Maleeva,5,83%
Conchita Mart\xc3\xadnez,6,1,Zina Garrison,5,83%
Zina Garrison,6,1,Michelle Casati,5,83%
Zina Garrison,6,1,Anne Harris,5,83%
Zina Garrison,6,1,Elna Reinach,5,83%
Samantha Stosur,6,1,Daniela Hantuchova,5,83%
Anastasia Pavlyuchenkova,6,1,Daniela Hantuchova,5,83%
Zuzana Ondraskova,6,1,Eva Birnerova,5,83%
Victoria Azarenka,6,1,Lucie Safarova,5,83%
Petra Kvitova,6,1,Sara Errani,5,83%
Zina Garrison,6,1,Bettina Bunge,5,83%
Henrieta Nagyova,6,1,Lenka Nemeckova,5,83%
Sandra Zahlavova,6,1,Renata Voracova,5,83%
Flavia Pennetta,6,1,Dominika Cibulkova,5,83%
Helena Sukova,6,1,Barbara Potter,5,83%
Gabriela Sabatini,6,1,Julie Halard-Decugis,5,83%
Cristina Torrens Valero,6,1,Eva Bes,5,83%
Sandrine Testud,6,1,Ai Sugiyama,5,83%
Anastasia Pavlyuchenkova,6,1,Carla Su\xc3\xa1rez Navarro,5,83%
Am\xc3\xa9lie Mauresmo,5,0,Meghann Shaughnessy,5,100%
Am\xc3\xa9lie Mauresmo,5,0,Magui Serna,5,100%
Caroline Wozniacki,5,0,Sloane Stephens,5,100%
Chris Evert,5,0,Mary Lou Daniels,5,100%
Chris Evert,5,0,Ivanna Madruga-Osses,5,100%
Chris Evert,5,0,Eva Pfaff,5,100%
Chris Evert,5,0,Andrea Leand,5,100%
Dinara Safina,5,0,Roberta Vinci,5,100%
Evonne Goolagong Cawley,5,0,Wendy Turnbull,5,100%
Jelena Jankovic,5,0,Sania Mirza,5,100%
Jennifer Capriati,5,0,Zina Garrison,5,100%
Jennifer Capriati,5,0,Natasha Zvereva,5,100%
Jennifer Capriati,5,0,Maria Vento-Kabchi,5,100%
Justine Henin,5,0,Ana Ivanovic,5,100%
Justine Henin,5,0,Alicia Molik,5,100%
Justine Henin,5,0,Mara Santangelo,5,100%
Kim Clijsters,5,0,Samantha Stosur,5,100%
Kim Clijsters,5,0,Karolina Sprem,5,100%
Lindsay Davenport,5,0,Francesca Schiavone,5,100%
Lindsay Davenport,5,0,Anne Kremer,5,100%
Lindsay Davenport,5,0,Karolina Sprem,5,100%
Lindsay Davenport,5,0,Tatiana Panova,5,100%
Lindsay Davenport,5,0,Tamarine Tanasugarn,5,100%
Lindsay Davenport,5,0,Anne-Gaelle Sidot,5,100%
Lindsay Davenport,5,0,Gala Leon Garcia,5,100%
Lindsay Davenport,5,0,Nicole Pratt,5,100%
Maria Sharapova,5,0,Sara Errani,5,100%
Maria Sharapova,5,0,Tatiana Golovin,5,100%
Maria Sharapova,5,0,Kirsten Flipkens,5,100%
Maria Sharapova,5,0,Tsvetana Pironkova,5,100%
Martina Hingis,5,0,Magdalena Maleeva,5,100%
Martina Hingis,5,0,Tatiana Panova,5,100%
Martina Hingis,5,0,Barbara Rittner,5,100%
Martina Navratilova,5,0,Andrea Temesvari,5,100%
Martina Navratilova,5,0,Candy Reynolds,5,100%
Serena Williams,5,0,Shahar Peer,5,100%
Serena Williams,5,0,Andrea Petkovic,5,100%
Serena Williams,5,0,Dominika Cibulkova,5,100%
Serena Williams,5,0,Anastasia Pavlyuchenkova,5,100%
Serena Williams,5,0,Urszula Radwanska,5,100%
Steffi Graf,5,0,Stephanie Rehe,5,100%
Steffi Graf,5,0,Meredith McGrath,5,100%
Steffi Graf,5,0,Marianne Werdel-Witmeyer,5,100%
Steffi Graf,5,0,Terry Phelps,5,100%
Steffi Graf,5,0,Nicole Muns-Jagerman,5,100%
Tracy Austin,5,0,Dianne Fromholtz (balestrat),5,100%
Venus Williams,5,0,Aliz\xc3\xa9 Cornet,5,100%
Dominika Cibulkova,5,0,Kristina Mladenovic,5,100%
Chanda Rubin,5,0,Karina Habsudova,5,100%
Barbara Potter,5,0,Kathleen Horvath,5,100%
Serena Williams,5,0,Nathalie Dechy,5,100%
Venus Williams,5,0,Roberta Vinci,5,100%
Roberta Vinci,5,0,Galina Voskoboeva,5,100%
Julia Goerges,5,0,Shahar Peer,5,100%
Arantxa Sanchez-Vicario,5,0,Silvia Farina Elia,5,100%
Yanina Wickmayer,5,0,Bojana Jovanovski,5,100%
Venus Williams,5,0,Amy Frazier,5,100%
Amy Frazier,5,0,Yuka Yoshida,5,100%
Monica Seles,5,0,Helen Kelesi,5,100%
Elena Bovina,5,0,Alexandra Stevenson,5,100%
Serena Williams,5,0,Eleni Daniilidou,5,100%
Eleni Daniilidou,5,0,Jelena Kostanic Tosic,5,100%
Jana Novotna,5,0,Elena Likhovtseva,5,100%
Elena Likhovtseva,5,0,Larisa Neiland,5,100%
Maria Sharapova,5,0,Kaia Kanepi,5,100%
Sylvia Hanika,5,0,Rosalyn Nideffer,5,100%
Arantxa Sanchez-Vicario,5,0,Ruxandra Dragomir Ilie,5,100%
Ruxandra Dragomir Ilie,5,0,Kveta Peschke,5,100%
Steffi Graf,5,0,Sandra Cecchini,5,100%
Manuela Maleeva-Fragniere,5,0,Sandra Cecchini,5,100%
Anabel Medina Garrigues,5,0,Mar\xc3\xada Emilia Salerni,5,100%
Lindsay Davenport,5,0,Daja Bedanova,5,100%
Natasha Zvereva,5,0,Sabine Appelmans,5,100%
Sabine Appelmans,5,0,Ruxandra Dragomir Ilie,5,100%
Sabine Appelmans,5,0,Marianne Werdel-Witmeyer,5,100%
Caroline Wozniacki,5,0,Virginie Razzano,5,100%
Helena Sukova,5,0,Melissa Gurney,5,100%
Alexandra Stevenson,5,0,Tara Snyder,5,100%
Martina Navratilova,5,0,Alycia Moulton,5,100%
Martina Navratilova,5,0,Andrea Leand,5,100%
Steffi Graf,5,0,Ines Gorrochategui,5,100%
Helena Sukova,5,0,Patty Fendick,5,100%
Vera Zvonareva,5,0,Sybille Bammer,5,100%
Maria Sharapova,5,0,Tamarine Tanasugarn,5,100%
Tamarine Tanasugarn,5,0,Yuka Yoshida,5,100%
Barbora Strycova,5,0,S\xc3\xadlvia Soler-Espinosa,5,100%
Anna Smashnova,5,0,Klara Koukalova,5,100%
Victoria Azarenka,5,0,Irina-Camelia Begu,5,100%
Agnieszka Radwanska,5,0,Karolina Pliskova,5,100%
Serena Williams,5,0,Anastasia Myskina,5,100%
Anastasia Myskina,5,0,Magui Serna,5,100%
Andrea Jaeger,5,0,Kathy Rinaldi Stunkel,5,100%
Andrea Jaeger,5,0,Candy Reynolds,5,100%
Serena Williams,5,0,Conchita Mart\xc3\xadnez,5,100%
Conchita Mart\xc3\xadnez,5,0,Radka Zrubakova,5,100%
Conchita Mart\xc3\xadnez,5,0,Wiltrud Probst,5,100%
Na Li,5,0,Ekaterina Makarova,5,100%
Na Li,5,0,Casey Dellacqua,5,100%
Na Li,5,0,Nicole Pratt,5,100%
Na Li,5,0,Tiantian Sun,5,100%
Svetlana Kuznetsova,5,0,Nicole Vaidisova,5,100%
Svetlana Kuznetsova,5,0,Agnes Szavay,5,100%
Joannette Kruger,5,0,Cristina Torrens Valero,5,100%
Tamarine Tanasugarn,5,0,Shinobu Asagoe,5,100%
Martina Hingis,5,0,Tathiana Garbin,5,100%
Raffaella Reggi,5,0,Anne Harris,5,100%
Gabriela Sabatini,5,0,Bettina Fulco-Vilella,5,100%
Linda Wild,5,0,Tami Jones,5,100%
Bettina Bunge,5,0,Iva Budarova,5,100%
Nathalie Tauziat,5,0,Nicole Bradtke,5,100%
Arantxa Sanchez-Vicario,5,0,Rita Grande,5,100%
Iveta Melzer,5,0,Angelika Roesch,5,100%
Dinky Van Rensburg,5,0,Wendy Prausa,5,100%
Gabriela Sabatini,5,0,Etsuko Kaneshiro,5,100%
Patty Schnyder,5,0,Gisela Dulko,5,100%
Maria Kirilenko,5,0,Gisela Dulko,5,100%
Martina Hingis,5,0,Kveta Peschke,5,100%
Mana Endo,5,0,Yone Kamio,5,100%
Lori McNeil,5,0,Camille Benjamin-Schermerhorn,5,100%
Stephanie Rehe,5,0,Camille Benjamin-Schermerhorn,5,100%
Larisa Neiland,5,0,Camille Benjamin-Schermerhorn,5,100%
Jo Durie,5,0,Elise Burgin,5,100%
Sandrine Testud,5,0,Gala Leon Garcia,5,100%
Henrieta Nagyova,5,0,Gala Leon Garcia,5,100%
Kristina Brandi,5,0,Lilia Osterloh,5,100%
Sabrina Goles,5,0,Tina Mochizuki,5,100%
Nathalie Tauziat,5,0,Asa Svensson,5,100%
Julie Halard-Decugis,5,0,Federica Bonsignori,5,100%
Helena Sukova,5,0,Mercedes Paz,5,100%
Victoria Azarenka,5,0,Monica Niculescu,5,100%
Carla Su\xc3\xa1rez Navarro,5,0,Monica Niculescu,5,100%
Monica Seles,5,0,Patricia Hy-Boulais,5,100%
Jana Novotna,5,0,Rachel McQuillan,5,100%
Gabriela Sabatini,5,0,Rachel McQuillan,5,100%
Magdalena Maleeva,5,0,Rachel McQuillan,5,100%
Natasha Zvereva,5,0,Rachel McQuillan,5,100%
Shahar Peer,5,0,Kateryna Bondarenko,5,100%
Conchita Mart\xc3\xadnez,5,0,Kristie Boogert,5,100%
Vera Zvonareva,5,0,Shahar Peer,5,100%
Amanda Coetzer,5,0,Shi-Ting Wang,5,100%
Amanda Coetzer,5,0,Gala Leon Garcia,5,100%
Elena Dementieva,5,0,Lilia Osterloh,5,100%
Gabriela Sabatini,5,0,Brenda Schultz-McCarthy,5,100%
Hana Mandlikova,5,0,Mary Lou Daniels,5,100%
Hana Mandlikova,5,0,Terry Phelps,5,100%
Manuela Maleeva-Fragniere,5,0,Larisa Neiland,5,100%
Manuela Maleeva-Fragniere,5,0,Terry Phelps,5,100%
Anna Chakvetadze,5,0,Nadia Petrova,5,100%
Andrea Temesvari,5,0,Beth Herr,5,100%
Denisa Chladkova,5,0,Tatiana Poutchek,5,100%
Marianne Werdel-Witmeyer,5,0,Halle Carroll,5,100%
Natasha Zvereva,5,0,Wiltrud Probst,5,100%
Laura Garrone,5,0,Laura Lapi,5,100%
Andrea Jaeger,5,0,Anne Hobbs,5,100%
Wendy Turnbull,5,0,Anne Hobbs,5,100%
Martina Navratilova,5,0,Isabelle Demongeot,5,100%
Helena Sukova,5,0,Isabelle Demongeot,5,100%
Sylvia Hanika,5,0,Isabelle Demongeot,5,100%
Venus Williams,5,0,Meilen Tu,5,100%
Shahar Peer,5,0,Meilen Tu,5,100%
Meilen Tu,5,0,Jolene Watanabe-Giltz,5,100%
Nicole Pratt,5,0,Meilen Tu,5,100%
Flavia Pennetta,5,0,Nuria Llagostera Vives,5,100%
Helena Sukova,5,0,Ann Henricksson,5,100%
Claudia Kohde-Kilsch,5,0,Ann Henricksson,5,100%
Arantxa Sanchez-Vicario,5,0,Alexandra Fusai,5,100%
Iva Majoli,5,0,Alexandra Fusai,5,100%
Sara Errani,5,0,Chanelle Scheepers,5,100%
Patty Schnyder,5,0,Martina Sucha,5,100%
Yvonne Meusburger,5,0,Julia Cohen,5,100%
Iroda Tulyaganova,5,0,Adriana Serra Zanetti,5,100%
Mary Lou Daniels,5,0,Sandy Collins,5,100%
Shuai Peng,5,0,Jill Craybas,5,100%
Jill Craybas,5,0,Karin Miller,5,100%
Laura Golarsa,5,0,Mercedes Paz,5,100%
Petra Kvitova,5,0,Marina Erakovic,5,100%
Kimberly Po-Messerli,5,0,Sandra Cacic,5,100%
Pam Shriver,5,0,Yvonne Vermaak,5,100%
Claudia Kohde-Kilsch,5,0,Eva Pfaff,5,100%
Claudia Kohde-Kilsch,5,0,Ann Kiyomura,5,100%
Dianne Fromholtz (balestrat),5,0,Mary Lou Daniels,5,100%
Dianne Fromholtz (balestrat),5,0,Ann Kiyomura,5,100%
Yanina Wickmayer,5,0,Francesca Schiavone,5,100%
Helena Sukova,5,0,Clare Wood,5,100%
Jelena Dokic,5,0,Magui Serna,5,100%
Tara Snyder,5,0,Lilia Osterloh,5,100%
Lilia Osterloh,5,0,Anna Tatishvili,5,100%
Kaia Kanepi,5,0,Maria Elena Camerin,5,100%
Virginia Wade,5,0,Kate Latham,5,100%
Serena Williams,5,0,Dally Randriantefy,5,100%
Silke Meier,5,0,Jenny Byrne,5,100%
Julie Halard-Decugis,5,0,Alexia Dechaume-Balleret,5,100%
Anna Smashnova,5,0,Anca Barna,5,100%
Kristina Mladenovic,5,0,Johanna Konta,5,100%
Steffi Graf,5,0,Sara Gomer,5,100%
Pam Shriver,5,0,Sara Gomer,5,100%
Anne Keothavong,5,0,Katie O'Brien,5,100%
Shi-Ting Wang,5,0,Shaun Stafford,5,100%
Judith Wiesner,5,0,Veronika Martinek,5,100%
Wendy Turnbull,5,0,Candy Reynolds,5,100%
Ana Ivanovic,5,0,Vania King,5,100%
Francesca Schiavone,5,0,Kimiko Date-Krumm,5,100%
Kimiko Date-Krumm,5,0,Rika Hiraki,5,100%
Magdalena Maleeva,5,0,Barbara Rittner,5,100%
Magdalena Maleeva,5,0,Martina Sucha,5,100%
Mary Joe Fernandez,5,0,Natasha Zvereva,5,100%
Mary Joe Fernandez,5,0,Patricia Hy-Boulais,5,100%
Mary Joe Fernandez,5,0,Laura Golarsa,5,100%
Samantha Stosur,5,0,Dominika Cibulkova,5,100%
Victoria Azarenka,5,0,Angelique Kerber,5,100%
Daniela Hantuchova,5,0,Dominika Cibulkova,5,100%
Daniela Hantuchova,5,0,Adriana Serra Zanetti,5,100%
Misaki Doi,5,0,Qiang Wang,5,100%
Julia Schruff,5,0,Tatiana Poutchek,5,100%
Angelique Kerber,5,0,Alla Kudryavtseva,5,100%
Johanna Larsson,5,0,Alla Kudryavtseva,5,100%
Angelique Kerber,5,0,Andrea Hlavackova,5,100%
Dinara Safina,5,0,Camille Pin,5,100%
Irina Spirlea,5,0,Nadine Ercegovic,5,100%
Maria Sharapova,5,0,Anastasia Rodionova,5,100%
Alla Kudryavtseva,5,0,Anastasia Rodionova,5,100%
Milagros Sequera,5,0,Samantha Reeves,5,100%
Maret Ani,5,0,Severine Beltrame,5,100%
Julie Coin,5,0,Ekaterina Bychkova,5,100%
Steffi Graf,5,0,Bettina Bunge,5,100%
Monica Seles,5,0,Chanda Rubin,5,100%
Amanda Hopmans,5,0,Sandra Kloesel,5,100%
Nana Smith Rogers,5,0,Rika Hiraki,5,100%
Tatjana Maria,5,0,Renata Voracova,5,100%
Sharon Fichman,5,0,Madison Brengle,5,100%
Kristin Godridge,5,0,Sung-Hee Park,5,100%
Lauren Davis,5,0,Nicole Gibbs,5,100%
Ana Ivanovic,5,0,Flavia Pennetta,5,100%
Flavia Pennetta,5,0,Aliz\xc3\xa9 Cornet,5,100%
Katerina Maleeva,5,0,Mercedes Paz,5,100%
Mima Jausovec,5,0,Kate Latham,5,100%
Barbara Potter,5,0,Kathy Rinaldi Stunkel,5,100%
Barbara Potter,5,0,Kim Sands,5,100%
Martina Hingis,5,0,Julie Halard-Decugis,5,100%
Julie Halard-Decugis,5,0,Brenda Schultz-McCarthy,5,100%
Julie Halard-Decugis,5,0,Wiltrud Probst,5,100%
Rika Fujiwara,5,0,Julie Ditty,5,100%
Anna-Lena Friedsam,5,0,Nadiia Kichenok,5,100%
Nathalie Tauziat,5,0,Kathy Rinaldi Stunkel,5,100%
Maria Sharapova,5,0,Marion Bartoli,5,100%
Marion Bartoli,5,0,Gisela Dulko,5,100%
Marion Bartoli,5,0,Shenay Perry,5,100%
Tatiana Golovin,5,0,Ai Sugiyama,5,100%
Billie Jean King,5,0,Kerry Ann Melville (reid),5,100%
Claudia Kohde-Kilsch,5,0,Carling Bassett-Seguso,5,100%
Carling Bassett-Seguso,5,0,Sharon Walsh,5,100%
Mary Pierce,5,0,Dominique Monami,5,100%
Sandrine Testud,5,0,Lori McNeil,5,100%
Lori McNeil,5,0,Wendy Prausa,5,100%
